R 848 380
NO ./textures/floor.xpm
SO ./textures/wood.xpm
WE ./textures/mossy.xpm
EA ./textures/wall_1.xpm
S ./textures/sprites/caballeroBlack_1.xpm
F 0,0,0
C 0,0,139

11111111111111111111111111111
10000000001100000000000000001
10110000011100000000000010001
10210000000000000000000010001
10110000011100000000000010001
10000000001100000111011110001
11110111111111011100000010001
11110111111111011100000010001
11000000110101011101010010001
10000000000000001100200010001
10000000000000001101010010001
11000000110101000000000000001
11110111112101000000000000001
10000000001100000100000010001
10000000000000001010000121001
10000000001000010001010201001
10000000001101000000N00000001
10000000002100000001010000001
11111111111111111111111111111
