R 848 480
NO ./textures/mossy.xpm
SO ./textures/mossy.xpm
WE ./textures/mossy.xpm
EA ./textures/mossy.xpm
S ./textures/sprites/barrel.xpm
SU ./textures/sprites/barrel.xpm
SC ./textures/sprites/caballeroBlack_1.xpm
ST ./textures/redbrick.xpm
FT ./textures/redbrick.xpm

F 184,113,39
C 51,198,227

11111111111111111111111111111
10000000041100000000000000001
10110000011100000000000010001
10410000000000000000000010001
10110000011100000000000210001
10000000001120000111011110001
11110111111111011100000210001
11110111111111011103030010001
11000000114101011100400010001
10000000000000001103030010001
10000000000000001102000020001
11000000110101000000000000001
11110111114101000000302000001
10000000001100000100000010001
10000000000000002000000001001
10000000001000010003030001001
10000000001101000000N20000001
10000000004100000003030000001
11111111111111111111111111111