R 848 480
NO ./textures/sky_1.xpm
SO ./textures/sky_1.xpm
WE ./textures/sky_1.xpm
EA ./textures/sky_1.xpm
S ./textures/sprites/barrel.xpm
SC ./textures/sprites/caballeroBlack_1.xpm
F 184,113,39
C 51,198,227

11111111111111111111111111111
10000000001100000000000000001
10110000011100000000000010001
10010000000000000000000010001
10110000011100000000000010001
10000000001100000111011110001
11110111111111011100000010001
11110111111111011131010010001
11000000110101011100000010001
10000000000000001100000010001
10000000000000001102010020001
11000000110101000000000000001
11110111110101000000302000001
10000000001100000100000010001
10000000000000002000000001001
10000000001000010003030001001
10000000001101000000N20000001
10000000000100000003030000001
11111111111111111111111111111