R 1920 1080
NO ./textures/redbrick.xpm
SO ./textures/wood.xpm
WE ./textures/mossy.xpm
EA ./textures/graffiti.xpm
S ./textures/sprites/barrel.xpm
F 209,209,209
C 23,236,255

11111111111111111111111111111
10000000000011000000000000001
10000000000011000000000000001
10000000000000000000000000001
10000000000000000000000000001
10000000000200000000000000111
10000000000000000000000000001
10000000000000000200000000001
10000000200000000000000000001
10000000000000000000000000001
100000000000N0000000000000001
11111111111111111111111111111