R 134651364551365415563145651346513564365245642654426344524346243465246344264651456531 700
NO ./textures/redbrick.xpm
SO ./textures/wood.xpm
WE ./textures/mossy.xpm
EA ./textures/bluestone.xpm
S ./textures/sprites/caballeroBlack_1.xpm
F 0,255,0
C 255,0,0

111111
1N0021
100001
100001
100001
100001
101001
100001
100001
102001
101101
111111
