R 848 480
NO ./textures/redbrick.xpm
SO ./textures/wood.xpm
WE ./textures/mossy.xpm
EA ./textures/bluestone.xpm
S ./textures/sprites/barrel.xpm



F 209,209,209
C 100,149,237


        1111111111111111111111111
        1000000000110200000000001
        1011000001110000002000001
        1001002000000000200000001
111111111011000001110000000200001
100000000011000001110111111111111
11110111111111011100000010001
11110111111111011101010010001
11000000110101011100000000201
10000200000200001102000010001
10000002000000001101010010001
11000001110101011111011110N0111
11110111 1110101 101111010001
11111111 1111111 111111111111
